5 11

-----------
|C|0|0|B|B|
|000BB000B|
|B|0|1|1|F|
-----------