9 9

---------
|       |
| - - - |
|   C   |
|B-B-B-B|
|   F   |
| - - - |
|       |
---------