9 9

---------
|   F 1 |
| - - - |
|       |
|B------|
|   s   |
|------B|
|   C   |
---------



