5 9

---------
|   BsFB|
| - -B-B|
| C   BB|
---------
