9 9

---------
|       |
|   C   |
|       |
|       |
| ------|
| | F   |
|       |
---------