9 13

-------------
|B    C    B|
|           |
|           |
|           |
|---  s  ---|
|           |
|B    E    B|
-------------
