9 9

---------
|   F 1 |
| - - - |
|       |
|P-----p|
|       |
| - - - |
|   C   |
---------
