7 11

-----------
|00000000B|
|C|0|0|B|B|
|000BB000F|
|B|0|2|B|B|
|000000000|
-----------