9 11

-----------
|    B   B|
|B| | |B|B|
|   BB   C|
| | | |B|B|
|         |
| | |s| | |
|  2 F 2  |
-----------