9 11

-----------
|         |
| | | | | |
|        C|
|B|B|B|B|B|
|         |
|2|2|2|2|2|
|FS 222   |
-----------
