9 11

-----------
|    B 2 B|
| |B|2|B|B|
|   BB 2 F|
|s| | |P|B|
|         |
| | | | | |
|    C    |
-----------