7 11

-----------
|00000000B|
|C|0|0|B|P|
|000Bp000F|
|B|0|1|2|s|
|000000000|
-----------